11111111111111111
10022002000000001
10101012101010101
10020002000000001
10101012101010101
10000002000000001
10101012101010101
10000022000220001
10101012101010101
12222222222222221
10101012101010101
10000002000000001
10101012101010101
10000002000220001
10101012101010101
10000002000000001
11111111111111111