11111111111111111111111111111111111
10000000000000000000000000000000001
10101010101010101010101010101010101
10000000000000000000000000000000001
10101010101010101010101010101010101
10000000022222222222222222222220001
10101010101010101010101010101010101
10000000000000000000000000000000001
10101010101010101010101010101010101
10000000000000000000000000000000001
10101010101010101010101010101010101
10000000000000000000000000000000001
10101010101010101010101010101010101
10000000000000000000000000000000001
10101010101010101010101010101010101
10000000000000000000000000000000001
10101010101010101010101010101010101
12222222222222200000000000000000001
10101010101010101010101010101010101
10000000000000000000000000000000001
10101010101010101010101010101010101
10000000000000022222222222222222001
10101010101010101010101010101010101
10000000000000000000000000000000001
10101010101010101010101010101010101
10000000000000000000000000000000001
10101010101010101010101010101010101
10000222222222222222220000000000001
10101010101010101010101010101010101
10000000000000000000000000000000001
10101010101010101010101010101010101
10000000000000000000000000000000001
10101010101010101010101010101010101
10000000000000000000000000000000001
11111111111111111111111111111111111